AABBD BCBBD
ABBBB DBBCB
AABBD BCBBD
ABBBB DBBCB
AABBD BCBBD
ABBBB DBBCB
AABBD BCBBD
ABBBB DBBCB
AABBD BCBBD
ABBBB DBBCA